9 14
**************
* A          *
*    *       *
*    *       *
*  ***       *
*            *
*     *****  *
*     ***    *
**************